///////////
/         /
/    |    /
/         /
///////////